autor=J. Franklin Mentzer

########################
##   #  #  #  #  #  #  ##
#   $        $          #
##.# #.###.#.$ #.$$###.##
#  #.# #.$ # $ #   # #  #
# .###.##  # $ #$$$# #. #
#  #.# #.$ # $$# @ # #  #
##.#$#.###.###.###.###.##
#   $           $  $ $  #
##  #  #  #  #  #  #   ##
########################
validatecode=
loesungsweg=
