#######
###   #
###$.$#####
#   . $   #
# ##$## @ #
#   . #####
### . #
###   #
#######
validatecode=
loesungsweg=
