#########
#   *   #
# $.#.$ #
#  $.$  #
###.$.###
####@####
#########
