###########
###   #####
###$.$#####
#   . $   #
# ##$## @ #
#   . #####
### . #####
###   #####
###########
validatecode=
loesungsweg=
